11111111111111111
10000011111100001
102P001000E100001
10N20011111100001
11111111111111111
