11111111111111111111111
10000000000000000000001
10000000000000000000001
10000N00000000000P00001
10000000000100000000001
10000000000100000000001
10000000000111100000001
10000000000000100000001
1000000000EC00000000001
10000000000000000000001
10000000000000000000001
11111111111111111111111