11111111111111111
10000000011100001
1C0P000000E100001
10N00000011100001
11111111111111111