1111111111111111111111111111111
10000000111100000001
1000000010c1000000011100000001
100000001001000000010000000m00000001
100000001111000000010000000P00000001
10000000E000000010000000100000001
10000000100000001
10000000u00000001
1111111111111111111111111111111
